R 1920 1080

NO ./Makefile
SO ./Makefile
WE ./Makefile
EA ./Makefile
S ./Makefile

F 220,100,0
C 225,30,0

        11111111111111111111111111111
        10000000001100000000000000001
1111111111110N00002000001000111111111
100100000000000000001111100000000000111111
101100000111000000001  1001000000000000001
100000000011000001111  1100000000000000001
111101111111111111001111010001111111111111
11110111111111011101010010001
11000000110101011100000010001
10000000000000000000000010001
10000000000000001101010010001
11000000110101011111011110001
11110111111101011111011110001
11111111111111111111111111111

