R 1280 720

NO ./Makefile
SO ./Makefile
WE ./Makefile
EA ./Makefile
S ./Makefile

F 255,0,0
C 63,115,237

        11111111111111111111111111111
        10000000001100000000000000001
        10000000001100000000000000001
1111111111110000002000001001100111111
102100000000000000001001100110000000111111
101100000111000000001001200000000000000021
100000000011000001111001100000000000000021
111101111111111111021111110011111111111111
11110111111121211101110010001
11000000112101011100000010001
10000000000000000000000010001
10000000000000001101010010001
11000000112101011111011110001
11112111111121211111011110N01
11111111111111111111111111111
