R 1280 720

NO ./txt/crate_n.xpm
SO ./txt/crate_s.xpm
WE ./txt/crate_w.xpm
EA ./txt/crate_e.xpm
S ./txt/sprite.xpm

F 220,100,0
C 63,115,237

        11111111111111111111111111111
        10000000001100000000000000001
        10000000001100000000000000001
1111111111110000000000001001100111111
100100000000000000001001100110000000111111
101100000111000000001001000000000000000001
100000000011000001111001100000000000000001
111101111111111111001111110011111111111111
11110111111101011101110010000001
11000000110101011100000010000001
10000000000000000000000010000001
10000000000000000000000010000001
10000000000000010000000010000001
10000000000000100000000010000001
10000000000000000000000010000001
10020000000000000000000010000001
10000000000000000000000000000001
10000000000000000000000010000001
10000000000000001101010010000001
11000000110101011111011110000001
11000000110101011111011110000001
11000000110101011111011110000001
11000000110101011111011110000001
1100000011010101101101111000111111
1100000011010101101101111000000001
1100000011010101101101111000000001
1100000011010101101101111000000001
11000000110101000000011110N0000001
1111011111110101111101111000000001
1111111111111111111111111111111111
