R 1280 720

NO ./txt/CRATE25.xpm
SO ./txt/CRATE25.xpm
WE ./txt/CRATE25.xpm
EA ./txt/CRATE25.xpm
S ./txt/sprite.xpm

F 220,100,0
C 63,115,237

        11111111111111111111111111111
        10000000001100000000000000001
        10000000001100000000000000001
1111111111110000002000001001100111111
102100000000000000001001100110000000111111
101100000111000000001001200000000000000021
100000000011000001111001100000000000000021
111101111111111111021111110011111111111111
11110111111121211101110010000001
11000000112101011100000010000001
10000000000000000000000010000001
10000000000000000000000010000001
10000000000000010000000010000001
10000000000000100000000010000001
10000000000000000000000010000001
10000000000000000000000010000001
10000000000000000000000010000001
10000000000000000000000010000001
10000000000000000000000010000001
10000000000000000000000010000001
10000000000000000000000010000001
10000000000000000000000010000001
10000000000000000000000010000001
10000000000000000000000010000001
10000000000000000000000010000001
10000000000000000000000010000001
10000000000000000000000010000001
10000000000000000000000010000001
10000000000000000000000010000001
10000000000000000000000010000001
10000000000000000000000010000001
10000000000000000000000010000001
10000000000000000000000010000001
10000000000000000000000010000001
10000000000000000000000010000001
10000000000000000000000010000001
10000000000000000000000010000001
10000000000000000000000010000001
10000000000000000000000010000001
10000000000000000000000010000001
10000000000000000000000010000001
10000000000000000000000010000001
10000000000000000000000010000001
10000000000000000000000010000001
10000000000000000000000010000001
10000000000000000000000010000001
10000000000000000000000010000001
10000000000000000000000010000001
10000000000000000000000010000001
10000000000000000000000010000001
10000000000000000000000010000001
10000000000000000000000010000001
10000000000000000000000010000001
10000000000000000000000010000001
10000000000000000000000010000001
10000000000000000000000010000001
10000000000000000000000000000001
10000000000000000000000010000001
10000000000000001101010010000001
11000000110101011111011110000001
11000000110101011111011110000001
11000000110101011111011110000001
11000000110101011111011110000001
1100000011010101121101111000111111
1100000011010101101101111000000001
1100000011010101101101111000000001
1100000011010101101101111000000001
1100000011210100020001111000000001
11112111111121011111011110N0000001
1111111111111111111111111111111111
